13 13 13 13 13 13 13 13 13 13 13 13 13 13 13 13 13 13 13 13 13 13 13 13 13 13 13 13 13 13 13 13 13 13
4 25 25 25 25 25 25 25 25 25 25 25 25 25 25 25 25 25 25 25 25 25 25 25 5 13
14 -1 -1 -1 -1 -1 -1 -1 -1 -1 -1 -1 -1 -1 -1 -1 -1 -1 -1 -1 -1 -1 -1 -1 12 13
14 -1 -1 -1 -1 -1 -1 -1 -1 -1 -1 -1 -1 -1 -1 -1 -1 -1 -1 -1 -1 -1 -1 -1 12 13
14 -1 -1 -1 -1 -1 -1 -1 -1 -1 -1 -1 -1 -1 -1 -1 39 -1 -1 -1 -1 -1 -1 -1 12 13
14 -1 -1 -1 -1 -1 -1 -1 -1 -1 -1 -1 -1 -1 39 -1 -1 -1 -1 -1 -1 -1 -1 -1 12 13
14 -1 -1 -1 -1 -1 -1 -1 -1 -1 -1 -1 -1 -1 -1 -1 -1 -1 36 37 38 -1 -1 -1 12 13
14 -1 -1 -1 -1 -1 -1 -1 0 1 1 1 2 -1 -1 -1 -1 -1 -1 -1 -1 -1 39 -1 12 13
14 -1 -1 -1 -1 -1 -1 -1 12 13 13 13 14 -1 -1 -1 -1 -1 -1 -1 -1 -1 -1 -1 12 13
16 1  1  1  1  1  1  1  17 13 13 13 16 1 1 1 1 2 -1 -1 -1 0 1 1 1 17
13 13 13 13 13 13 13 13 13 13 13 13 13 13 13 13 13 14 -1 -1 -1 12 13 13 13 13
13 13 13 13 13 13 13 13 13 13 13 13 13 13 13 13 13 14 -1 -1 -1 12 13 13 13 13
13 13 13 13 13 13 13 13 13 13 13 13 13 13 13 13 13 14 -1 -1 -1 12 13 13 13 13
13 13 13 13 13 13 13 13 13 13 13 13 13 13 13 13 13 14 -1 -1 -1 12 13 13 13 13